NO cub3dimg/1.png
SO cub3dimg/2.png
WE cub3dimg/3.png
EA cub3dimg/4.png

F 205, 141, 122
C 123, 211, 234

        1111111111 111111111111111
        1000000000110001  100000001
        1011000001110000111110000001
        1001000000000000000000001111111111
111111111011000001110000000000001
1000000000110000011101111111111111
11110111111111011100000010001
11110111111111011101010010001
11000000110101011100000010001
1000000000000000110000001000111111111111
1000000000000000110101000000000000000001
1100000111010101111101100N00000000000001
11110111 1110101 10111100010111111111111
11111111 1111111 111111111111
11111111111111111111111111111